[10,10]
(4,4)
(1,3)|(9,0)|(9,9)
(0,0,1,4)
(0,4,2,1)
(2,2,5,1)
(2,3,1,4)
(3,6,3,1)
(6,3,1,2)
(8,0,1,4)
(8,5,1,5)
(1,8,1,2)
(4,8,1,2)
(6,8,1,2)